TILEMAP
60 44 							-- Size of tile map in tiles
16 16 							-- Tile size & block size
images/terrain.png 	-- Tilesheet
8 8								-- Number of tiles in tilesheet
000000000000000000000000000000000000000000000000000000000000
000000000000000000000000000000000000000000000000000000000000
000000000000000000000000000000000000000000000000000000000000
000000000000000000000000000000000000000000000000000000000000
000000000000000000000000000000000000000000000000000000000000
000000000000000000000000000000000000000000000000000000000000
000000000000000000000000000000000000000000000000000000000000
000000000000000000000000000000000000000000000000000000000000
000000000000000000000000000000000000000000000000000000000000
000000000000000000000000000000000000000000000000000000000000
000000000000000000000000000000000000000000000000000000000000
000000000000000000000000000000000000000000000000000000000000
00000000000000000000000000000000000000000_000000000000000000
00000000000000.000000000000000000000122222222223000000000000
00000000000000000000000000000000000094444444444A000000000000
00000000000012223000000000000000000094444444444A000000000000
0000000000009444A000000000000000000094444444444A000000000000
0000000000009444A000000000000000122244444444444A000000000000
0000000000009444A000000?00000000944444444444444A000000000000
00000000000094444222222222222222444444444444444A000000000000
00000000000094444444444444444444444444444444444A000000000000
666666666666666666666666666666666666666666666666666666666666
EEEEEEEEEEEEEEEEEEEEEEEEEEEEEEEEEEEEEEEEEEEEEEEEEEEEEEEEEEEE
000000000000KIIIIIIIIIIIIIIIIIIIIIIIIIIIIIIIIIIJ000000000000
000000000000KIIIICCCCCCCCCCCCCCCIIIIIIIIIIIIIIIJ000000000000
000000000000KIIIJ000000000000000KIIIIIIIIIIIIIIJ000000000000
000000000000KIIIJ000000!00000000HCCCIIIIIIIIIIIJ000000000000
000000000000KIIIJ0000000000000000000KIIIIIIIIIIJ000000000000
000000000000HCCCB0000000000000000000KIIIIIIIIIIJ000000000000
000000000000000000000000000000000000KIIIIIIIIIIJ000000000000
00000000000000,000000000000000000000HCCCCCCCCCCB000000000000
00000000000000000000000000000000000000000-000000000000000000
000000000000000000000000000000000000000000000000000000000000
000000000000000000000000000000000000000000000000000000000000
000000000000000000000000000000000000000000000000000000000000
000000000000000000000000000000000000000000000000000000000000
000000000000000000000000000000000000000000000000000000000000
000000000000000000000000000000000000000000000000000000000000
000000000000000000000000000000000000000000000000000000000000
000000000000000000000000000000000000000000000000000000000000
000000000000000000000000000000000000000000000000000000000000
000000000000000000000000000000000000000000000000000000000000
000000000000000000000000000000000000000000000000000000000000