TILEMAP
60 44 							-- Size of tile map in tiles
16 16 							-- Tile size & block size
images/terrain.png 	-- Tilesheet
8 8								-- Number of tiles in tilesheet
000000000000000000000000000000000000000000000000000000000000
000000000000000000000000000000000000000000000000000000000000
000000000000000000000000000000000000000000000000000000000000
000000000000000000000000000000000000000000000000000000000000
000000000000000000000000000000000000000000000000000000000000
000000000000000000000000000000000000000000000000000000000000
000000000000000000000000000000000000000000000000000000000000
000000000000000000000000000000000000000000000000000000000000
000000000000000000000000000000000<<<<<0000000000000000000000
0000000000000000000000000<<001222222222222222222230000000000
0000000000000000000000001222244444444444444444444A0000000000
000000000000000000000000944444444444444444444444442300000000
000000000000000000000000944444444444444444444444444A00000000
000000000000000000000000XMMMMMMMMMMMMMMMMMMMMMM4444A00000000
0000000000000000000000000000^^^^^^^^^^^000000009444A00000000
000000000000000000000000000000000000000000000009444A00000000
000000000000000000000000000000000000000000000009444A00000000
0000000000000000000000.0000000000000000000000009444A00000000
0000000000?0000000000000000000000000000000000_09444A00000000
000000001222222222222222222222222222222222222244444A00000000
000000009444444444444444444444444444444444444444444A00000000
666666666666666666666666666666666666666666666666666666666666
EEEEEEEEEEEEEEEEEEEEEEEEEEEEEEEEEEEEEEEEEEEEEEEEEEEEEEEEEEEE
00000000KIIIIIIIIIIIIIIIIIIIIIJ000000KIIIIIIIIIIIIIJ00000000
00000000HCCCCCCCCCCCCCCCCCCCCCB000000HCCCCCCCCCCCCCB00000000
000000000000000000000000000000000000000000000-00000000000000
0000000000!0000000000000000000000000000000000000000000000000
00000000000000000000UVVVVW0000000000000000000000000000000000
00000000000000000000KIIIIJ0000000000000000000000000000000000
00000000000000000000HCCIIJ0000000000000000000000000000000000
00000000000000000000000KIJ0000000000000000000000000000000000
0000000000000000000000,KIJ0000000000000000000000000000000000
00000000000000000000000HCB0000000000000000000000000000000000
000000000000000000000000000000000000000000000000000000000000
000000000000000000000000000000000000000000000000000000000000
000000000000000000000000000000000000000000000000000000000000
000000000000000000000000000000000000000000000000000000000000
000000000000000000000000000000000000000000000000000000000000
000000000000000000000000000000000000000000000000000000000000
000000000000000000000000000000000000000000000000000000000000
000000000000000000000000000000000000000000000000000000000000
000000000000000000000000000000000000000000000000000000000000
000000000000000000000000000000000000000000000000000000000000
000000000000000000000000000000000000000000000000000000000000
