TILEMAP
60 44 							-- Size of tile map in tiles
16 16 							-- Tile size & block size
images/terrain.png 	-- Tilesheet
8 8								-- Number of tiles in tilesheet
000000000000000000000000000000000000000000000000000000000000
000000000000000000000000000000000000000000000000000000000000
000000000000000000000000000000000000000000000000000000000000
000000000000000000000000000000000000000000000000000000000000
000000000000000000000000000000000000000000000000000000000000
000000000000000000000000000000000000000000000000000000000000
000000000000000000000000000000000000000000000000000000000000
000000000000000000000000000000000000000000000000000000000000
000000000000000000000000000000000000000000;00000000000000000
000000000000000000000000000000000000000000000001300000000000
000000000000000000000000000000000000000000122224A00000000000
000000000000000000000000000000000000000000XMMMMMY00000000000
00000000000000000_000000000000000000000000000000000000013000
00000000000000012223000000000000000000000000000000001224A000
00000000.000000XMMMY00000000000000000000000000000000XMMMY000
0000000000<<000000000000000000000000000000000000000000000000
000000012223000000000000000000000000000000000000000000000000
0000000XMMMY000000000000:00000000000000000000000000000000000
000000000000000000000000000*0000<<<00000000000000?0000000000
000000000000012222222222222222222230000000000122222230000000
0000000000000944444444444444444444A00000000009444444A0000000
666666666666666666666666666666666666666666666666666666666666
EEEEEEEEEEEEEEEEEEEEEEEEEEEEEEEEEEEEEEEEEEEEEEEEEEEEEEEEEEEE
0000000000000KIIIIIIIIIIJ0000000000KIIIIIIIIIIJ0000000000000
0000000000000HCCCCCCCIICB0000000000KICCCCCCCCCCB000000000000
00000000000000000-000HB000000000000KJ00000000000000000000000
00000000000000000000000000000000000KJ000!0000000000000000000
0000000000000000000000000000=0UVVVVIJ00000000000000000000000
000000000000000000000000000000HCCCCIJ00000000000000000000000
0000000000000000000000000000&000000HB00000000000000000000000
000000000000000000000000000000000000000000000000000000000000
00000000000000000000UVVVVVW000000000000000000000000000000000
00000000000000000000KICCCCB000000000000000000000000000000000
00000000000000000000KJ000^^000000000000000000000000000000000
00000000000000000000KJ,0000000000000000000000000000000000000
00000000000000000000KJ00000000000000000000000000000000000000
00000000000000000000HB00000000000000000000000000000000000000
00000000000000000000^^00000000000000000000000000000000000000
000000000000000000000000000000000000000000000000000000000000
000000000000000000000000000000000000000000000000000000000000
000000000000000000000000000000000000000000000000000000000000
000000000000000000000000000000000000000000000000000000000000
000000000000000000000000000000000000000000000000000000000000
000000000000000000000000000000000000000000000000000000000000
