TILEMAP
60 44 							-- Size of tile map in tiles
16 16 							-- Tile size & block size
images/terrain.png 	-- Tilesheet
8 8								-- Number of tiles in tilesheet
000000000000000000000000000000000000000000000000000000000000
000000000000000000000000000000000000000000000000000000000000
000000000000000000000000000000000000000000000000000000000000
000000000000000000000000000000000000000000000000000000000000
000000000000000000000000000000000000000000000000000000000000
000000000000000000000000000000000000000000000000000000000000
000000000000000000000000000000000000000000000000000000000000
000000000000000000000000000000000000000000000000000000000000
0000000000000:0000000000000000000000000000000000000000000000
0000000000*000000000000.000000000000000000000000000000000000
000000001222222223000<000<0000000000000000000000000000000000
00000000XMMMMMMMMY000122230000000000000000000000000000000000
000000000000000000000XMMMY000130:000000000000000000000000000
000000000000000000000000000009A0000<<00000000000000000000000
000000000000000000000000000009422222300000000000000000000000
00000000000000000000000000000XMMMMMMY00000000000000000000000
000000000000000000000000000000000000000000000000000000000000
000000000000000000000000000000000000;00000000000000000000000
0000000000?000000000000000000000000000000000000000_000000000
000000012222222223001222222222222222222222223000122222300000
000000094444444444A0090444444444444444444444A000944444400000
666666666666666666666666666666666666666666666666666666666666
EEEEEEEEEEEEEEEEEEEEEEEEEEEEEEEEEEEEEEEEEEEEEEEEEEEEEEEEEEEE
0000000KIIIIIIIIIJ00000000KIIIIIIIIIIIIIIIIIJ000000000000000
0000000HCCCCCCCCCB00000000KICCCCCCCCCCCCCIIIJ000000000000000
00000000000000000000000000KJ0000000000-00KIIJ000000000000000
00000000000!00000000UVVVW0KJ0000000000000KIIJ000000000000000
00000000000000000000HCCCB0KIVVVVVW0000000KIIJ000000000000000
00000000000000000000^000^0KIIIICCB0000000KIIJ000000000000000
00000000000000000000000000HCCCB^^^0000000HCIJ000000000000000
00000000000000000000000000^000^0000000000=0HB000000000000000
000000000000000000000000000000000000000000000000000000000000
000000000000000000000000000000000000000000,00000000000000000
000000000000000000000000000000000000000000000000000000000000
000000000000000000000000000000000000000000000000000000000000
000000000000000000000000000000000000000000000000000000000000
000000000000000000000000000000000000000000000000000000000000
000000000000000000000000000000000000000000000000000000000000
000000000000000000000000000000000000000000000000000000000000
000000000000000000000000000000000000000000000000000000000000
000000000000000000000000000000000000000000000000000000000000
000000000000000000000000000000000000000000000000000000000000
000000000000000000000000000000000000000000000000000000000000
000000000000000000000000000000000000000000000000000000000000
