TILEMAP
60 44 							-- Size of tile map in tiles
16 16 							-- Tile size & block size
images/terrain.png 	-- Tilesheet
8 8								-- Number of tiles in tilesheet
000000000000000000000000000000000000000000000000000000000000
000000000000000000000000000000000000000000000000000000000000
000000000000000000000000000000000000000000000000000000000000
000000000000000000000000000000000000000000000000000000000000
000000000000000000000000000000000000000000000000000000000000
000000000000000000000000000000000000000000000000000000000000
000000000000000000000000000000000000000000000000000000000000
000000000000000000000000000000000000000000000000000000000000
000000000000000000000000000000000000000000000000000000000000
000000000000000000000000000000000000000000000000001230000000
0000000000000000000000000000000000000000000000000094A0000000
0000000000000000000000000000000000000000000000000094A0000000
0000000000000000000000000000000000000000122222222244A0000000
0000000000000000000000000000000000000000944444444444A0000000
0000000000000000000000000000000000000000XMMMMMMMMM44A0000000
00000000000000000000000000000000000000000^^^^^^^^094A0000000
0000000000000000001230000000000000000000000000000094A0000000
000000000000000000944222222300000000000000000000.094A0000000
0000000000000000?0944444444A0_0000000000000000*00094A0000000
000000122222222222444444444422222222222222222222224443000000
00000094444444444444444444444444444444444444444444444A000000
666666666666666666666666666666666666666666666666666666666666
EEEEEEEEEEEEEEEEEEEEEEEEEEEEEEEEEEEEEEEEEEEEEEEEEEEEEEEEEEEE
000000KIIIIIIIIIIIIIIIIIIIIIIIIIIIIIIIIIIIIIIIIIIIIIIIIIIIIJ
000000HCCCCCIICCCCCCCCCCCIIIIIIIIIIIICCCCCCCCCCCCCCCCB000000
0000000000-0KJ00000000000KIIIIIIIIIIJ^^^^^^^^^^^^^^^^^000000
000000000000KJ000!0000000HCCCCCCCCCCB00000000000000000000000
000000000000KJ0<<<<0000000000000000000000UVVVVVVW00000000000
000000000000KIVVVVVW000000000000000000000KIICCIIJ00000000000
000000000000HCCCCCCB000000000000000000000HCB00HCB00000000000
000000000000000000=0000000000000000000000000000000000UVW0000
00000000000000000000000000000000000000000000000000000HCB0000
000000000000000000000000000000000000000000000000000000000000
000000000000000000000000000000000000000000000000000000,00000
000000000000000000000000000000000000000000000000000000000000
000000000000000000000000000000000000000000000000000000000000
000000000000000000000000000000000000000000000000000000000000
000000000000000000000000000000000000000000000000000000000000
000000000000000000000000000000000000000000000000000000000000
000000000000000000000000000000000000000000000000000000000000
000000000000000000000000000000000000000000000000000000000000
000000000000000000000000000000000000000000000000000000000000
000000000000000000000000000000000000000000000000000000000000
000000000000000000000000000000000000000000000000000000000000