TILEMAP
60 44 							-- Size of tile map in tiles
16 16 							-- Tile size & block size
images/terrain.png 	-- Tilesheet
8 8							-- Number of tiles in tilesheet
000000000000000000000000000000000000000000000000000000000000
000000000000000000000000000000000000000000000000000000000000
000000000000000000000000000000000000000000000000000000000000
000000000000000000000000000000000000000000000000000000000000
000000000000000000000000000000000000000000000000000000000000
000000000000000000000000000000000000000000000000000000000000
000000000000000000000000000000000000000000000000000000000000
000000000000000000000000000000000000000000000000000000000000
000000000000000000000000000000000000000000000000000000000000
000000000000000000000000000000000000000000000000000000000000
0000000000000000000000000000130_00000000000000000000.0000000
000000000000000000000000000094222222300000000000000000000000
000000000000000000000000000094444444A00000000000000123000000
000000000000000000000000000094444444A<<<00000000000XMY000000
000000000000000000000000000094444444422222222300000000000000
000000000000<<<<<0000000000094444444444444444A00000000000000
0000000000001222300000000000XMMMMMMMMMMMMMMMMY00000000000000
0000000000009444A0000000000000000000000000000000000000000000
0000000000009444A0000?00000000000000000000000000000000000000
000000000000944442222222222222222222222222222223000000000000
00000000000094444444444444444444444444444444444A000000000000
666666666666666666666666666666666666666666666666666666666666
EEEEEEEEEEEEEEEEEEEEEEEEEEEEEEEEEEEEEEEEEEEEEEEEEEEEEEEEEEEE
000000000000KIIIIIIIIIIIIIIIIIIIIIIIIIIIIIIIIIJ0000000000000
000000000000KIIIICCCCCCCCCCCCCCCCCCCCCCCCCCCCCCB000000000000
000000000000KIIIJ0000000000-00000000000000000000000000000000
000000000000KIIIJ0000!0000000000000000000000UVW0000000000000
000000000000KIIIJ0000000000000000UVVVVVVVVVVIIJ0000000000000
000000000000KIIIJ000UVVW000000000KIIIIIIIIIIIIJ0000000000000
000000000000HCCCB000HCCB000000000KIICCCCCCCCCCB0000000000000
000000000000000^^00000&0000000000KIJ000000000000000000000000
000000000000,00000000000000000000HCB000000000000000000000000
0000000000000000000000000000000000-0000000000000000000000000
000000000000000000000000000000000000000000000000000000000000
000000000000000000000000000000000000000000000000000000000000
000000000000000000000000000000000000000000000000000000000000
000000000000000000000000000000000000000000000000000000000000
000000000000000000000000000000000000000000000000000000000000
000000000000000000000000000000000000000000000000000000000000
000000000000000000000000000000000000000000000000000000000000
000000000000000000000000000000000000000000000000000000000000
000000000000000000000000000000000000000000000000000000000000
000000000000000000000000000000000000000000000000000000000000
000000000000000000000000000000000000000000000000000000000000